lines using words that begin with z	f(contain,lines,f(begin,words,z))
lines containing the word art	f(contain,lines,f(word,art))
lines containing words starting with t	f(contain,lines,f(word,f(start,t)))
lines that have sandwich but not word ham	f(contain,lines,f(and,sandwich,f(not,f(word,ham))))
lines containing words ending with t	f(contain,lines,f(word,f(ends,t)))
lines using word going followed by d	f(contain,lines,f(after,d,f(word,going)))
lines that contain bar	f(contain,lines,bar)
lines that ends with letter j	f(ends,lines,f(letter,ltrfltr))
lines using words ending with er	f(contain,lines,f(word,f(ends,er)))
lines that contain word dance	f(contain,lines,f(word,dance))
lines that contain word black and letter z	f(contain,lines,f(and,f(word,black),f(letter,z)))
lines that have words ending with ing	f(contain,lines,f(word,f(ends,ing)))
lines that do not contain letter e	f(not,lines,f(contain,f(letter,e)))
lines using word that contains letters der	f(contain,lines,f(word,f(contain,f(letters,der))))
lines that contain only letters agde	f(contain,lines,f(only,f(letters,agde)))
lines that contain only lowercase letters	f(contain,lines,f(only,f(lowercase,letters)))
lines that contain news before paper or show	f(contain,lines,f(before,news,f(or,paper,show)))
lines that contain atleast 5 numbers	f(contain,lines,f(atleast,numbers,5))
lines with sec before mun	f(contain,lines,f(before,sec,mun))
lines that contain only uppercase letter	f(contain,lines,f(only,f(uppercase,letter)))	
lines that contain atleast one vowel and atleast two numbers	f(contain,lines,f(and,f(atleast,one,vowel),f(atleast,two,numbers)))
lines containing foo or nu before dist or dust	f(contain,lines,f(before,f(or,foo,nu),f(or,dist,dust)))
lines that have bar	f(contain,lines,bar)
lines using q before r	f(contain,lines,f(before,q,r))
lines that contain WorldSPWarSPII and casualties	f(contain,lines,f(and,WorldSPWarSPII,casualties))
lines that end with o	f(ends,lines,o)
lines that do not contain any number	f(not,lines,f(contain,number))
lines using mno after pqr	f(contain,lines,f(after,mno,pqr))
lines that start with far	f(start,lines,far)
lines that end with and	f(ends,lines,and)
lines having words ending with ne	f(contain,lines,f(word,f(ends,ne)))
lines using su after son or soon	f(contain,lines,f(after,su,f(or,son,soon)))
lines that contain words with ru	f(contain,lines,f(word,ru))
lines that contain numbers	f(contain,lines,numbers)
lines that contain words ending with vowels	f(contain,lines,f(word,f(ends,vowels)))
lines that contain atleast 2 z	f(contain,lines,f(atleast,2,z))
lines using atleast 2 r	f(contain,lines,f(atleast,2,r))
lines that contain atleast 3 words and atleast 3 numbers	f(contain,lines,f(and,f(atleast,3,words),f(atleast,3,numbers)))
lines that contain numbers	f(contain,lines,numbers)
lines that contain words ending with vowels	f(contain,lines,f(word,f(ends,vowels)))
lines containing word using ause	f(contain,lines,f(word,f(contain,ause)))
lines that contain atleast 1 vowel and atleast 2 numbers	f(contain,lines,f(and,f(atleast,1,vowel),f(atleast,2,numbers)))
lines using atleast 3 characters	f(contain,lines,f(atleast,3,characters))
lines that contain words starting with pa	f(contain,lines,f(word,f(start,pa)))
lines using min before imal	f(contain,lines,f(before,min,imal))
lines that begin with number	f(start,lines,number)
lines that do not contain character z	f(not,lines,f(contain,z))
lines using words starting with bi	f(contain,lines,f(word,f(start,bi)))
lines containing letter	f(contain,lines,letter)
lines that contain mix or shake	f(contains,lines,f(or,mix,shake))
lines using atleast 5 d	f(contain,lines,f(atleast,5,d))
lines containing word	f(contain,lines,word)
lines containing ers and containing oxy too	f(contain,lines,f(and,ers,oxy))
lines that end in number	f(ends,lines,number)
lines containing words using vowel	f(contain,lines,f(word,f(contain,vowel)))
lines containing on and also containing off	f(contain,lines,f(and,on,off))
lines that end in digit	f(end,lines,digit)
lines that contain number 10	f(contain,lines,f(number,10))
lines that contain y and o but not z	 f(contain, lines, f(and, y, f(and, o, f(not, z))))
lines that contain atleast 1 z	f(contain,lines,f(atleast,1,z))